1111111111111
10000000001C1
1000011100001
1P0001E100001
1111111111111
