11111111111
10000000001
100000P0001
10000000001
1C000000001
1000000E001
11111111111
