1111111111111111111
10000000C00000P1111
1001011111000001111
10010000C0000P01111
1001000000000E01111
1000111110110000C11
1111111111111111111
