11111111111111111111
10000000C00000000C11
10010111110000011111
10010000C0000P01C111
100100C000000E011111
1000C111101100000C11
11111111111111111111
