1111111111111
10000000000C1
1000010100001
1P0001E100001
1111111111111
